{
  "tiles": [
      [0, 1, 1, 0, 0, 0, 1, 1, 0],
      [1, 1, 1, 1, 1, 1, 1, 1, 1],
      [1, 1, 1, 1, 1, 1, 1, 1, 1],
      [1, 1, 1, 1, 1, 1, 1, 1, 1],
      [0, 0, 1, 1, 1, 1, 1, 0, 0],
      [1, 1, 1, 1, 1, 1, 1, 1, 1],
      [1, 1, 1, 1, 1, 1, 1, 1, 1],
      [1, 1, 1, 1, 1, 1, 1, 1, 1],
      [0, 1, 1, 0, 0, 0, 1, 1, 0]
  ],
  "target": {
      "croissant": 6
  },
  "moves": 1
}
