{
  "tiles": [
      [0, 0, 0, 0, 0, 0, 0, 0, 0 ],
      [0, 1, 1, 1, 1, 1, 1, 1, 0 ],
      [0, 1, 1, 1, 1, 1, 1, 1, 0 ],
      [0, 1, 1, 1, 1, 1, 1, 1, 0 ],
      [0, 1, 1, 1, 0, 1, 1, 1, 0 ],
      [0, 1, 1, 1, 1, 1, 1, 1, 0 ],
      [0, 1, 1, 1, 1, 1, 1, 1, 0 ],
      [0, 1, 1, 1, 1, 1, 1, 1, 0 ],
      [0, 0, 0, 0, 0, 0, 0, 0, 0 ]
  ],
  "target": {
      "cupcake": 4,
      "donut": 4
  },
  "moves": 10
}
