{
  "tiles": [
      [0, 0, 1, 0, 0, 0, 1, 0, 0],
      [0, 1, 1, 1, 1, 1, 1, 1, 0],
      [1, 1, 0, 1, 1, 1, 0, 1, 1],
      [1, 1, 1, 1, 1, 1, 1, 1, 1],
      [0, 1, 1, 1, 1, 1, 1, 1, 0],
      [1, 1, 1, 1, 1, 1, 1, 1, 1],
      [1, 0, 1, 1, 1, 1, 1, 0, 1],
      [1, 0, 1, 1, 1, 1, 1, 0, 1],
      [0, 0, 1, 0, 0, 0, 1, 0, 0]
  ],
  "target": {
      "donut": 8
  },
  "moves": 12
}
